1111111111111111111
1322223333333222221
1313131313131313131
1222223333332222221
1313131313131313131
1222223333332222221
1313131313131313131
1222222222222222221
1313131313131313131
1222223333333222221
1313131313131313131
1222222222222222221
1313131313131313131
1222233333333222221
1313131313131313131
1333333333333333331
1313131313131313131
1333333333333333331
1111111111111111111