1111111111111111111
1433233311133323351
1333133132313313331
1333231331331323331
1122113331333112211
1333233331333323331
1131133331333311311
1221233332333321221
1111112211122111111
1221233331333321221
1131133331333311311
1333233331333323331
1122122211122212211
1333233332333323331
1233313331333133321
1313331331331333131
1313333132313333131
1313333311136333131
1111111111111111111
