1111111111111111111
122222       222221
1 1 1 1 1 1 1 1 1 1
122222      2222221
1 1 1 1 1 1 1 1 1 1
122222      2222221
1 1 1 1 1 1 1 1 1 1   
1222222222222222221
1 1 1 1 1 1 1 1 1 1   
122222       222221
1 1 1 1 1 1 1 1 1 1
1222222222222222221
1 1 1 1 1 1 1 1 1 1
12222        222221     
1 1 1 1 1 1 1 1 1 1   
1                 1
1   1 1 1 1 1 1 1 1   
1                 1
1111111111111111111
