1111111111111111111
1412223333333222221
1313131313131313131
1322223333332222221
1313131313131313131
1322223333332222221
1313131313131313131
1322222222222222221
1313131313131313131
1322223333333222221
1313131313131313131
1332222222222222221
1313131313131313131
1322233333333222211
1313131313131313131
1333333333333333331
1313131313131313131
1533333333333333361
1111111111111111111
