1111111111111111111
1333333333333333331
1333333333333333331
1333322333333333331
1333333333333333331
1333333333333333331
1333333333333333331
1333322333333333331
1333333333333333331
1333333333333333331
1333333333333333331
1333333333333333331
1333333332233333331
1333333333333333331
1333333333333333331
1333333333333333331
1333333333333223331
1333333333333333331
1111111111111111111