1111111111111111111
1332223333333232221
1313131313131313131
1222223333332222221
1313131313131313131
1222223333332222221
1313131313131313131
1222222333333332221
1313131313131313131
1222223333333222221
1313131313131313131
1222222233222222221
1313131313131313131
1222233222333223321
1313131313131313131
1333333333333333331
1333131313131313131
1333333333333333331
1111111111111111111
