1111111111111111111
1456333333333333331
1333333333333222221
1333333333333222221
1333333333333333331
1333333333333333331
1333333333333333331
1333333333333333331
1333333333333333331
1333333333333333331
1333333333333333331
1333333333333333331
1333333333333333331
1333333333333333331
1333333333333333331
1333333333333333331
1333333333333333331
1333333333333333331
1111111111111111111
