1111111111111111111
1222223333333222221
1313131313131313131
1222223333332222221
1313131313131313131
1222223333332222221
1313131313131313131
1222222333333322221
1313131313131313131
1222223333333222221
1313131313131313131
1222222233222222221
1313131313131313131
1222233333333222221
1313131313131313131
1333333333333333331
1333131313131313131
1333333333333333331
1111111111111111111
