1111111111111111111
1333333333333333331
1313113113333113131
1313313133333123131
1314313133533122131
1312312133333111131
1312212133333333331
1311111133313333331
1313333333333333331
1313333333333333331
1313111133333133331
1313122213333333331
1313122213333333131
1316133313333333331
1322233333333322231
1333333333333333331
1333333333333333331
1333333333333333331
1111111111111111111
